#....................................................................#
#....................................................................#
#....................................................................#
#....................................................................#
#....................................................................#
#....................................................................#
#....................................................................#
#....................................................................#
#....................................................................#
#....................................................................#
#....................................................................#
#....................................................................#
#....................................................................#
#....................................................................#
#....................................................................#
#....................................................................#
#.................#..................................................#
#.............#...#..................................................#
#.............#...#.#...#............................................#
#.............#...#.#.#.#............................................#
#.............#.#.#.#.#.#............................................#
#.............#.#.#.#.#.#............................................#
#.............#.#.#.#.#.#............................................#
#.............###########............................................#
#....................................................................#
#....................................................................#
#....................................................................#
#.....................#..............................................#
#.....................#..............................................#
#.....................#.#............................................#
#.................#...#.#.....#.#....................................#
#.................#.#.#.#.....#.#....................................#
#.................#.#.#.#.....#.#....................................#
#.................#.#.#.#.....#.#....................................#
#...............#.#.#.#.#.#.#.#.#....................................#
#...............#.#.#.#.#.#.#.#.#....................................#
#...............#################....................................#
#....................................................................#
#....................................................................#
#......................############..................................#
#....................................................................#
#....................................................................#
#.................................#..#...............................#
#.................................#..#...............................#
#.................................#..#...............................#
#.................................#..#...............................#
#...........................#######..#########.......................#
#...........................#................#.......................#
#...........................#................#.......................#
#...........................#................#.......................#
#...........................#................#.......................#
#...........................##################.......................#
#....................................................................#
#....................................................................#
#..........................................######....................#
#....................................................................#
#....................................................................#
#.......................................######.######................#
#....................................................................#
#....................................................................#
#....................................######.######.######............#
#....................................................................#
#....................................................................#
#.................................######.######.######.######........#
#....................................................................#
#....................................................................#
#..............................######.######.######.######.######....#
#....................................................................#
#....................................................................#
#....................................................................#
#................................#...................................#
#................................#...................................#
#................................#...................................#
#................................#.#.................................#
#................................#.#.................................#
#................................#.#.................................#
#................................#.#.....#...........................#
#..............................#.#.#.#.#.#...........................#
#..............................#.#.#.#.#.#...........................#
#..............................###########...........................#
#....................................................................#
#....................................................................#
#.......................................#####........................#
#....................................................................#
#....................................................................#
#....................................#####.#####.....................#
#....................................................................#
#....................................................................#
#.................................#####.#####.#####..................#
#....................................................................#
#....................................................................#
#..............................#####.#####.#####.#####...............#
#....................................................................#
#....................................................................#
#...........................#####.#####.#####.#####.#####............#
#....................................................................#
#....................................................................#
#.........................#..........................................#
#.........................#..........................................#
#.......................#.#..........................................#
#.......................#.#..........................................#
#.......................#.#..........................................#
#.......................#.#..........................................#
#.......................#.#.#........................................#
#.......................#.#.#........................................#
#.......................#.#.#........................................#
#.......................#.#.#........................................#
#.......................#####........................................#
#....................................................................#
#....................................................................#
#..........................#####.....................................#
#....................................................................#
#....................................................................#
#.......................#####.#####..................................#
#....................................................................#
#....................................................................#
#....................#####.#####.#####...............................#
#....................................................................#
#....................................................................#
#..........#...........#.............................................#
#..........#############.............................................#
#....................................................................#
#....................................................................#
#........................#..#........................................#
#........................#..#........................................#
#....................#####..####.....................................#
#....................#.........#.....................................#
#....................#.........#.....................................#
#....................#.........#.....................................#
#....................#.........#.....................................#
#....................###########.....................................#
#....................................................................#
#......................#.............................................#
#.............##########.............................................#
#....................................................................#
#....................................................................#
#..........#....#....................................................#
#..........#....#....................................................#
#..#########....####.................................................#
#..#...............#.................................................#
#..#...............#.................................................#
#..#################.................................................#
#....................................................................#
#....................................................................#
#....................................................................#
#..............................#.....#...............................#
#..............................#######...............................#
#....................................................................#
#....................................................................#
#..........................#...#.....................................#
#..........................#...#.....................................#
#.....................######...######................................#
#.....................#.............#................................#
#.....................#.............#................................#
#.....................#.............#................................#
#.....................###############................................#
#....................................................................#
#....................................................................#
#..................#####.............................................#
#....................................................................#
#...............#####.#####..........................................#
#....................................................................#
#............#####.#####.#####.......................................#
#....................................................................#
#.........#####.#####.#####.#####....................................#
#....................................................................#
######################################################################
